12:12
00 00 00 00 00 00 00 00 00 00 00 00
00 00 00 00 32 33 34 35 36 00 00 00
00 00 00 00 00 00 00 48 00 00 00 00
00 00 49 00 00 00 00 00 00 00 00 00
00 00 00 00 00 00 00 00 00 00 00 00
00 00 00 00 00 00 00 00 00 00 00 00
00 00 17 17 17 17 17 17 17 00 00 00
00 00 00 17 18 20 18 17 00 00 00 00
00 00 00 00 00 00 00 00 00 00 00 00
00 00 00 00 00 17 00 00 00 00 00 00
00 00 00 00 00 00 00 00 17 00 17 00
18 32 00 00 00 00 00 00 17 33 17 00
