12:12
00 00 00 00 00 00 00 00 00 00 00 00
00 00 00 00 00 33 32 32 32 32 00 00
18 00 00 00 00 00 00 57 00 00 00 00
00 18 00 00 00 00 00 00 00 00 00 00
00 00 18 00 00 00 00 00 00 00 00 00
00 00 00 00 00 00 00 00 00 00 00 00
00 00 17 17 17 17 17 17 17 00 00 00
00 00 00 17 18 00 18 17 00 00 00 00
00 00 00 00 00 00 00 00 00 00 00 00
00 00 00 00 00 17 00 00 00 00 00 00
00 00 00 00 00 00 00 00 17 00 17 00
18 32 00 64 00 00 00 00 17 33 17 00
