12:12
00 00 00 00 00 00 00 00 00 00 00 00
00 00 00 00 00 33 34 35 36 37 38 00
00 00 00 00 00 00 00 57 00 00 00 00
00 00 00 00 00 00 00 00 00 00 00 00
00 00 00 00 00 00 00 00 00 00 00 00
00 00 00 00 00 00 00 00 00 00 00 00
00 00 17 17 17 17 17 17 17 00 00 00
00 00 00 17 18 20 18 17 00 00 00 00
00 00 00 00 00 00 00 00 00 00 00 00
00 00 00 00 00 17 00 00 00 00 00 00
00 00 00 00 00 00 00 00 17 00 17 00
18 32 00 00 00 00 00 00 17 33 17 00
