12:12
00 00 00 00 00 00 00 00 00 00 17 17
00 00 00 00 32 00 00 00 00 00 00 00
00 00 17 00 00 00 00 00 00 00 00 17
00 00 00 00 00 00 00 17 00 00 00 00
00 00 00 17 00 00 00 00 00 00 00 00
00 00 00 00 00 00 00 00 00 00 00 00
00 00 17 17 00 17 17 00 17 00 00 00
00 00 00 17 18 20 18 17 00 00 00 00
00 00 00 00 00 00 00 00 00 00 00 00
00 54 00 00 00 17 00 00 00 00 00 00
00 00 00 00 00 00 00 00 17 00 17 00
18 32 00 00 00 00 00 00 17 32 17 00